28 27 
9 9 9 9 1 1 1 1 1 0 0 1 1 1 1 1 1 1 1 1 1 1 1 1 9 9 9 9 
9 9 9 9 0 0 0 1 1 0 0 1 0 0 0 0 0 0 1 0 0 0 0 0 9 9 9 9 
9 9 9 9 0 0 0 1 1 0 0 1 2 2 2 2 2 2 1 0 0 0 0 0 9 9 9 9 
9 9 9 9 0 0 0 1 1 0 0 1 2 2 2 2 2 2 1 0 0 0 0 0 9 9 9 9 
9 9 9 9 0 0 0 1 1 0 0 1 2 2 2 2 2 2 1 0 0 0 0 0 9 9 9 9 
9 9 9 9 0 0 0 1 1 0 0 1 2 2 2 2 2 2 1 0 0 0 0 0 9 9 9 9 
9 9 9 9 1 1 1 1 0 0 0 0 1 1 1 1 1 1 1 1 1 1 1 1 9 9 9 9 
9 9 9 9 0 0 0 1 0 0 0 0 0 0 0 0 0 0 1 0 0 0 0 0 9 9 9 9 
9 9 9 9 0 0 0 1 0 0 0 0 0 0 0 0 0 0 1 0 0 0 0 0 9 9 9 9 
9 9 9 9 0 0 0 1 0 0 0 0 0 0 0 0 0 0 1 0 0 0 0 0 9 9 9 9 
9 9 9 9 0 0 0 1 0 0 0 0 0 0 0 0 0 0 1 0 0 0 0 0 9 9 9 9 
9 9 9 9 1 1 1 1 0 0 0 0 0 0 0 0 0 0 1 1 1 1 1 1 9 9 9 9 
9 9 9 9 1 0 0 0 0 0 0 0 0 0 0 0 0 0 0 0 0 0 0 1 9 9 9 9 
9 9 9 9 1 0 0 0 0 0 0 0 0 0 0 0 0 0 0 0 0 0 0 1 9 9 9 9 
9 9 9 9 1 0 0 0 0 0 0 0 0 0 0 0 0 0 0 0 0 0 0 1 9 9 9 9 
9 9 9 9 1 0 0 0 0 0 0 0 0 0 0 0 0 0 0 0 0 0 0 1 9 9 9 9 
9 9 9 9 1 0 0 0 0 0 0 0 0 0 0 0 0 0 0 0 0 0 0 1 9 9 9 9 
9 9 9 9 1 0 0 0 0 0 0 0 0 0 0 0 0 0 0 0 0 0 0 1 9 9 9 9 
9 9 9 9 1 0 0 0 0 0 0 0 0 0 0 0 0 0 0 0 0 0 0 1 9 9 9 9 
9 9 9 9 1 0 0 0 0 0 0 0 0 0 0 0 0 0 0 0 0 0 0 1 9 9 9 9 
9 9 9 9 1 0 0 0 0 0 0 0 0 0 0 0 0 0 0 0 0 0 0 1 9 9 9 9 
9 9 9 9 1 0 0 0 0 0 0 0 0 0 0 0 0 0 0 0 0 0 0 1 9 9 9 9 
9 9 9 9 1 0 0 0 0 0 0 0 0 0 0 0 0 0 0 0 0 0 0 1 9 9 9 9 
9 9 9 9 1 0 0 0 0 0 0 0 0 0 0 0 0 0 0 0 0 0 0 1 9 9 9 9 
9 9 9 9 1 0 0 0 0 0 0 0 0 0 0 0 0 0 0 0 0 0 0 1 9 9 9 9 
9 9 9 9 1 0 0 0 0 0 0 0 0 0 0 0 0 0 0 0 0 0 0 1 9 9 9 9 
9 9 9 9 1 0 0 0 0 0 0 0 0 0 0 0 0 0 0 0 0 0 0 1 9 9 9 9 
